{
    "width": 10,
    "height": 10,
    "tiles": [
        ["W", "W", "W", "W", "W", "W", "W", "W", "W", "W"],
        ["W", ".", ".", ".", ".", ".", ".", ".", ".", "W"],
        ["W", ".", ".", ".", "W", "W", ".", ".", ".", "W"],
        ["W", ".", "P", ".", ".", ".", ".", ".", ".", "W"],
        ["W", ".", ".", "B", ".", ".", "W", ".", ".", "W"],
        ["W", ".", "W", ".", "B", ".", ".", ".", ".", "W"],
        ["W", ".", ".", ".", ".", "B", ".", ".", ".", "W"],
        ["W", ".", ".", "T", "T", "T", ".", ".", ".", "W"],
        ["W", ".", ".", ".", ".", ".", ".", ".", ".", "W"],
        ["W", "W", "W", "W", "W", "W", "W", "W", "W", "W"]
    ]
}
