{
    "width": 8,
    "height": 8,
    "tiles": [
        ["W", "W", "W", "W", "W", "W", "W", "W"],
        ["W", ".", ".", ".", ".", ".", ".", "W"],
        ["W", ".", ".", ".", ".", ".", ".", "W"],
        ["W", ".", "W", "W", ".", ".", ".", "W"],
        ["W", ".", ".", "B", ".", "T", ".", "W"],
        ["W", ".", "P", ".", ".", ".", ".", "W"],
        ["W", ".", ".", ".", ".", ".", ".", "W"],
        ["W", "W", "W", "W", "W", "W", "W", "W"]
    ]
}
