{
    "width": 7,
    "height": 7,
    "tiles": [
        ["W", "W", "W", "W", "W", "W", "W"],
        ["W", "T", ".", "T", ".", "T", "W"],
        ["W", ".", "B", "B", "B", ".", "W"],
        ["W", "T", "B", "P", "B", "T", "W"],
        ["W", ".", "B", "B", "B", ".", "W"],
        ["W", "T", ".", "T", ".", "T", "W"],
        ["W", "W", "W", "W", "W", "W", "W"]
    ]
}
