{
    "width": 8,
    "height": 8,
    "tiles": [
        ["W", "W", "W", "W", "W", "W", "W", "W"],
        ["W", ".", ".", ".", ".", ".", ".", "W"],
        ["W", ".", "P", ".", ".", ".", ".", "W"],
        ["W", ".", "B", ".", "W", ".", ".", "W"],
        ["W", ".", "B", ".", "T", ".", ".", "W"],
        ["W", ".", ".", ".", "T", ".", ".", "W"],
        ["W", ".", ".", ".", ".", ".", ".", "W"],
        ["W", "W", "W", "W", "W", "W", "W", "W"]
    ]
}
